R  1080 720

NO ./map/textures/brick.xpm

SO ./map/textures/blue.xpm

WE ./map/textures/wood.xpm

EA ./map/textures/grey.xpm

S ./map/textures/chest.xpm

F 224,172,105

C 205,249,255
11111
100S1
1111
