R 720 1080
NO ./map/textures/brick.xpm
SO ./map/textures/blue.xpm
WE ./map/textures/wood.xpm
EA ./map/textures/grey.xpm
S ./map/textures/chest.xpm
F 224,172,105
C 205,249,255
1
11111111111111111111111111
1S010000010011001000001001
11111111111111111111111111
