R  300 720
NO ./map/textures/brick.xpm
SO ./map/textures/blue.xpm

WE ./map/textures/wood.xpm

EA ./map/textures/grey.xpm

S ./map/textures/chest.xpm
F 224,172,105
C 205,249,255

 111111111111
10200000000021
10S01 1111111
 10011
11 1
11 11
10001
10001
10001
11111
