R  720 1080
NO ./map/textures/brick.xpm
SO ./map/textures/blue.xpm
WE ./map/textures/wood.xpm
EA ./map/textures/grey.xpm
S ./map/textures/chest.xpm
F 214,130,125
C 245,244,205
1111111111
1200000001
1000000001
1000000001
1000000001
1000000001
1000000001
1000000001
10000000N1
1111111111
