R 500 500
NO ./map/textures/brick.xpm
SO ./map/textures/blue.xpm
WE ./map/textures/wood.xpm
EA ./map/textures/grey.xpm
S ./map/textures/barrel.xpm
F 214,130,125
C 245,244,205
11111111111111111111
12000000000000000001
10000000000000000001
10000000000000000001
10000000000000000001
10000000000000000001
10000000000000000001
10000000000000000001
10000000000000000001
10000000000000000001
10000000000000000001
10000000000000000001
10000000000000000001
10000000000000000001
10000000000000000001
10000000000000000001
100000000000000000N1
11111111111111111111
