R  100 100
NO ./map/textures/brick.xpm
SO ./map/textures/blue.xpm
WE ./map/textures/wood.xpm
EA ./map/textures/grey.xpm
S ./map/textures/chest.xpm
F 214,130,125
C 245,244,205
11111
12021
10N01
12021
11111
