R  1080 720
NO ./textures/brick.xpm
SO ./textures/blue.xpm
WE ./textures/wood.xpm
EA ./textures/grey.xpm

S ./textures/chest.xpm
F 224,172,105
C 205,249,255

11111111111111111111111111
10010000010011001000001001
10001000000011001000001001
10010000010011001000000001
10001000000011001000000001
10000001000011001000001001
10010000012200001000001001
10000001002211001000001001
10010000012N11001000001001
10010000012011001000001001
10001000000211001000001001
10000001002011000000001001
10010000010011001000001001
11111111111111111111111111
